vortex
timhalb
160
19
19
1111111111111111111
1000000000000020003
1011111111111111101
1020000000020000001
1010111111111110101
1010200002000000101
1010101111111010101
1010102020000010101
1010102011101010101
1010100024201010101
1010101111101010101
1010000020002010101
1010111111111010101
1000000002000020101
1011111111111110101
3000000000020000201
1111111111111111101
0300000000000020001
1111111111111111111