Round the Bend
KiggD
16
11
11
0 0 0 0 0 0 1 0 1 0 0
0 0 0 0 0 3 0 0 0 0 0
0 1 1 1 1 1 1 2 1 0 0
0 1 0 0 0 0 2 0 1 0 2
0 1 0 0 2 0 2 0 0 1 0
1 0 2 1 0 0 1 1 0 0 0
1 0 0 0 0 2 1 0 0 0 0
0 1 0 0 1 0 0 0 0 0 0
1 0 0 1 0 0 0 0 0 0 0
1 4 1 0 0 0 0 0 0 0 0
0 1 0 0 0 0 0 0 0 0 0