Saturated
Jamesandpie
37
19
19
4020202020202020212
0202020202020202020
2020202020202021202
0202020212020202020
2020202020202020202
0202020202020212020
2020202120202020202
0212020202021202120
2020202020202020202
0202020202020202020
2020202120202021202
0202120202021202020
2020202020202020202
0212020202020202020
2020202021202020202
0202020202020212020
2020212020202020202
0212020202021202023
2020202020202020202