Puncture
timhalb
52
17
17
00000000100000000
00000011011000000
00001100000110000
00010001010001000
01110111211101110
00022100200122000
00100101410100100
01011101010111010
01220001010002210
01010102020101010
01010012121001010
00001000100010000
01000110301100010
00100012121000100
00010220002201000
00010010101001000
00011111111111000