Stuck Zipper
Anorhc
30
19
5
1 1 1 1 1 1 1 1 1 1 1 1 1 1 1 1 1 1 1
0 1 0 1 0 1 0 1 0 1 0 1 0 0 0 1 0 1 0
4 2 0 2 0 2 0 2 0 2 0 2 0 2 0 2 0 0 0
0 0 2 0 2 0 2 0 2 0 2 0 2 0 2 0 0 3 0
1 0 1 0 1 0 1 0 1 0 1 0 1 0 1 0 1 0 1