Trick Question
Jamesandpie
76
19
19
0020000204201000100
0010001221020112200
2101110010122002010
0201002100201010010
0202000012101000210
2010020020020121020
1011002110101000010
0020200001200010100
1011022012011202100
0221100100002000202
0200010012010121100
1010001201010000012
0001121020001101220
0002320101120010010
0101002000002020020
0201002101200200110
1011001020112111200
0020102020022000220
0020020100200001200