confusion
lovedky
311
20
19
00000000000000102000
00111211112221002100
01000102000001202020
22210002110000001000
00001202002011122100
10201001010100010020
01100101000202010200
00002122211200222120
00110100000201000010
01020210201112202010
01220001200201211010
01001020101200102010
01002102010202102010
01010010200100100222
22222001000100100100
02020100111212221000
10201022020200001222
02020100200202021010
20302222020202212004