The House of God
Jamesandpie
41
19
19
0000010023200100000
0000102002002010000
0001020022200201000
0010202200022020100
0102121020201212010
1020202010102020201
0202020210120202020
0202020210120202020
2111111112111111112
0000000004000000000
2111111112111111112
0210020010120200120
0001202210200102000
1010010020122012221
0022001110200210100
2210210010122210002
0002012201000201210
1012020020022202000
0000220200100020232