Detour
Raszlo
96
19
13
1111111101111101111
1410211102011120011
1202000002000000211
1020211120011110011
1202000020100010111
1020211112101020111
1202000000201001101
0020211111101020120
1202000000020120200
0020211101222020110
1202011002020010020
1000201111011111010
1110000000020000003