Stars
jamesandpie
20
19
19
0000232000000232000
0222222002220222222
0232000002320000232
0222002222220222222
0000002320000232000
0222222220000222022
0232320002220000023
0222220002320000022
0000022202220022200
0000023202222023200
0222022202332022200
0232000022222022222
0222002223200023223
0002222322200022222
0222322220222000000
0232220000232022200
0222322220222023200
0002222320022222222
4000002220023200023