Mysterioso
Jamesandpie
38
19
19
0101011011110101010
1010102100201010101
0140010121101101010
1010011010001010121
0101000102010101010
1121010001002000101
0020100102010101010
1010001010112200101
0001110201000010020
0100110100101020101
0110121001202010101
0100102010101010101
2021020202020120100
0101001110101101010
0201010100010102000
0201210201001310101
1010022110200010012
1000111020012101020
2020000001100002000