Small Intestines
timhalb
68
19
19
4200000000000000000
2111111111111111120
0100000000000000000
0121011111111122010
0101000000000002010
0101011111111111010
0101000000000001010
0100111111111101010
0100000000000001010
0111111111111101010
0100200000000001010
0110111111111101010
0100200000000021000
0111111111110101111
0100200000000000000
0110111111111111110
0100200000000000010
0201111111111111010
0000000000000000013