No mercy 2
Raszlo
144
19
19
1111111111110000111
4010211020000220211
1202000002021202021
0020210020213220211
1202001202001202001
0020210020210020211
1102221202001102221
0000210020210000211
1202001202001202001
0020210000210020211
1202001102221202031
2020110020210020211
1200001202001202001
0020210020210020011
1202001011001001111
0020211000010020111
1202011211201120001
1020000001000020103
1111111111111111111