T Total
timhalb
121
17
16
11011111111000011
13031000000002011
11011222222210201
10201202020212221
12221110101110001
10001000100010001
10001220102211011
11011020102010201
10201101110112221
12021000100010001
10001202120210001
11011020102011011
10201101110110201
12221020010012221
10000220000010001
10001020011110401