K2XL Games
Jamesandpie
47
19
19
2302000201001020002
2020100200202102120
2200020202020010200
2021020200201002020
2002121222220220202
0110000100011201100
0221010201201020020
2002000202020120010
0020101220010121020
0200100202100120010
2222010200220022222
1101002111001001000
0001200022010210200
0202110200202002022
0120100102020022020
0202011021002201102
2010200222211020222
0000101000000102020
1220020000010000024