Industrial Bell
KiggD
42
19
19
0000000000000000000
0000000000000000000
0000000000100000000
0000000001010000000
0011000110001100000
0100101002020010000
0000110021212001000
0012000101010100100
0010211011011010010
0110000001010100100
0001111101411001000
1010000001011001000
0000111001011100000
0011000001010010000
0100100100200010000
0103000100101201000
0100000100010020000
0111111100011111100
0000000000000000000