OriginofSymmetry
timhalb
7
13
11
0000031300000
0000010100000
0110200020110
0102010102001
0111212121110
0100024200010
0131212121310
1002010102001
0110200200110
0000010100000
0000031300000