line of sight
cdntennispro
239
20
20
20202001121100101101
20002010000011302010
00202010111020100001
22202010121020012221
00201210101021200101
00210000121000010101
00100111101111001101
20101000121000101001
10101010101010101011
20202020242020202020
00101010121010101011
01122210000010001001
01000001101121110201
01020201010202210001
01021101202012112221
01001000020201000000
01001101202002022111
00102010111112001101
10012000000002011010
01002011121111111101