Preemptive Pink
amelioratio
323
20
20
20000002010000000000
20012222200011211100
00100002012100200010
02201111101001110010
00100020000010001010
22121010121200122220
00000000200101000010
00112221121001020100
20200101020001022201
02224000022201000100
20200101100101012221
00112221020100120000
00200000020200001020
20002010202111020110
01011221001000101000
03102020110010122210
20202001020020000010
00210210021002020220
20201122020121111200
22000000010000000000