Soggy Waffles
KiggD
111
20
20
00000202000000000000
00000202000000001001
02020202011111111020
20202000100000001222
20202111100011001000
20202001000020200100
02020001000020020100
01012221002020201020
00000201100011020100
22202010122210200100
02020010104010000102
20202120011102220100
02020220002000001121
30202020210111110000
11111202010100002000
00020020212010002000
02200201010112120000
10201111110100210000
00110020002000201000
00000000010100210000