Shoelace
KiggD
11
9
8
000000000
040000000
000010000
000000010
000110100
000010000
000000130
000000000
