All Boxed Up
Jamesandpie
48
19
19
0000201200120000203
2120010001201202020
0002201022020121002
2001020201202020220
0210000000020201000
2002011112111120222
0220010020200102200
1000010200020102022
2002212012102100020
0210020024200221000
2022212012102100202
2202010200020102000
0022010020200120200
2100011112111100020
0000202020000202000
0210020201000020200
0000202022220200100
2020000200000020000
2220221000102001000