Russian Doll
Jamesandpie
104
19
19
0200102000000000000
0101020111111111101
0101011000000000020
0101010011111111000
0101010100202031010
0101010102000201010
0101010120202021010
0101010102120201010
0101010120212021010
0101010102020201010
0101010020202021010
0101010001111110010
0101010000000000102
0101011111111111120
0102000000000000001
0101211111111111110
0100000000000000000
0111111111111111112
4000000000000000000