Vent
KiggD
15
13
11
0000000100000
0000000010111
0000001001001
0001100100401
0001101001001
0010010000111
3000101000000
0010000000000
0000001000000
0000010000000
0100000000000