Truancy
Jamesandpie
40
19
19
0000000002000000000
0000000002001000000
0000001002000000000
0001111111110010000
0001020100010000000
0011002000011222222
0000020120010000000
0110112101110101000
0100020020130000000
0100010000101000000
0111111104100000000
0020200111101000000
0020101000020100000
0020200100001000000
0020012022000000000
0020100000000000000
0020020100000000000
0020000000000000000
0020000000000000000