Psyplosion
amelioratio
488
20
20
10000000101000000000
00211110002022022100
02200201012002010022
01001200102021011000
01014202101120020100
01010100000001120010
00010111211000020210
21010000001112110010
00011212100000010100
01210202012111012221
01001000102001010000
01021222120202001020
02202010002021020110
01020010021202020020
01201020202020011200
00000212020200100100
02102020202011020010
00200210020102001222
20112110211102013000
00000000000000010201