HotDog
KiggD
32
19
5
0000000001000010000
0000101001000000010
4001000100100100110
0000101001000010130
0000001000010000100