Checkmate
Jamesandpie
56
19
19
4000000000000000000
0000000000000000000
2020202020202020202
0202020202020202020
2020202020202020202
0202020202020202020
2020202020202020202
0202020202020202020
2020202020202020202
0121212121212121210
2020202020202020200
0000000000100020210
0000000020022101021
1000000100010210100
0202020202021000000
1020202020200000000
0202020202020000000
0020202020200000000
3202020202020000000