crazystylie
Jamesandpie
33
19
19
2202202202020202020
0020022020002020202
2002200022220202220
0220002202002002002
2002201120200202200
0200020002020200202
2022202022022022020
0202200202210202020
0020122020020020202
0202420222200202020
0020121020122002021
0202000202202020200
2200202022022020200
0022020202200202022
0202020022020021200
2020202020202202020
0202220200200202202
0220202020202022020
2020020222020202003