No mercy 1
Raszlo
156
19
19
1111111111100000111
4010211020002220211
1202000002021202001
0020210020210020211
1202001202001202001
0020210020210020211
1202001202001202001
0020210020210020211
1202001202001202001
2220110000210020111
1200001102221200001
0020210020210020211
1202001202001202001
0020210020210020211
1202001111001001111
0020213111010020111
1002012001011120001
1110000000000020103
1111111111111111111