Handywork
KiggD
40
20
15
40000000000100000000
00000001000100000000
00000010000100000000
00000100000100000000
00001000000100000000
00010011111001111111
00100100000000000001
01010000100001110001
01000010010000000001
01000000000001110001
00100010010000000001
01010001001001110001
01001000000100000001
01000010010001111011
00000100100001300001