Tetris
Anorhc
61
19
19
0000001000002000003
2201121012111111210
0220100002201001020
0111001102002001000
0002001122221000100
0002220001001002100
0110100001001120010
0110110201021002100
0010102221221120010
0002000000201002100
0010011111111120010
2110000020011002100
221001022021120010
0200110211221002100
1102210110021120010
1122000000201002100
1111222201001120013
0001100111212000100
0011040022221120000