Shield
timhalb
34
14
16
10010010010010
00100101001001
01001000100100
10000010010010
00100011001001
01001010010100
10000001000010
00101410011001
00000010100010
10101010011100
10010100113011
01001010010010
00000001001001
10101010010010
01000100100100
10101010001001