Duel Carrigeway 1
Jamesandpie
70
19
19
0020220020220200200
0220200202020020012
0020220020220201200
2020202100210201020
0020220002002201202
2021200210220122020
0002121000020100001
2020200110112101200
1202120202000023010
2020210122212101202
0202020102010200200
2021200102010202022
0202020202022021200
2020210202000020222
0202120202010020020
2020200002102202020
0202021222022010002
2020000202201202020
0202020104010000200