Enclosure
Jamesandpie
38
15
15
000000000000000
011110111100000
210001020111100
020200020002100
021211101102100
000011000101100
210211010001000
010002010210000
110111000101000
132020211220100
100010000242010
111112101022101
000010001101010
000011110121100
000000000000000