StuckZipper
Anorhc
30
19
5
1111111111111111111
0101010101010001010
4202020202020202000
0020202020202020030
1010101010101010101