one plus one makes
Raszlo
97
20
17
11111310202022210000
32000212020202000020
10111010202020211110
10141012021102000210
10101010001010222010
00120232200301020210
02131110211111202010
01020020200001020210
02220000111021002010
00011112121202020210
11110020131020202010
11111210111111111110
11111020000000001020
11111011212110102000
11111111020010121020
11111111011110001111
11111111111111111111