trapdoor
Jamesandpie
34
10
10
4200202200
0202000200
0220222220
0202020200
1010101012
0202000200
1212121220
0000000020
1010222210
0020000003