The Rabbit Hole
timhalb
12
8
9
0 0 0 0 1 1 1 0
0 0 0 0 1 0 1 1
0 1 1 1 1 2 3 1
1 1 0 1 0 0 0 1
1 0 2 0 2 2 1 1
1 0 0 2 0 0 1 0
1 0 2 0 2 0 1 0 
1 4 0 2 0 1 1 0
1 1 1 1 1 1 0 0