Flowerbed
Jamesandpie
69
19
19
0020100200230200000
0002022202022010000
0201200002020122000
0020022210101020100
2222002002200202002
0020210222021010100
0011022202202001020
0222020220020001010
0002202202220202020
2001220024202110202
0010001122100202010
2020002000012010200
0021010222010102000
0200202200202202210
0202022012102020200
0010200100020101000
2001012020101020202
0001020202221000200
0020000200000000000