Corner 2 Corner
Jamesandpie
58
19
19
4020101010210200000
0202200100200010122
2100121012011102200
0201002020102010100
0100100200000101010
0202001011010020202
0001221100210001210
2002002020102102020
0010201002000001200
0001020021001210021
0102010001020200101
2010120201001012000
0020002010010202100
0201212102200020220
2102020100202101002
0001210010100020220
0220200020012010202
2100011202000202100
0021020020010020203