brain
timhalb
32
19
19
2230222222222222222
2020202000202000202
2222202222202022202
2000202020202020002
2222222020222222222
2000002020202020202
2022222220202020202
2020200020202020202
2220222222202220202
2000200000202020202
2222202222222022202
2020202020002020002
2022222222222220222
2020002020200020202
2222222020202220202
2020000020202000202
2022222220202222222
2000200000200000242
2222222222222222222