Escapology
KiggD
10
6
6
4 0 0 1 0 0
0 0 0 1 0 0
0 0 0 1 0 0
1 2 1 1 0 0
0 0 0 0 0 0
0 0 0 0 0 3