Cross Eyed
timhalb
22
19
19
2121212121212121212
1200000010100000021
2020000100010000202
1002001000001002001
2000210001000120002
1000120000000210001
2001022000002201002
1010200200020020101
2102000020200002012
1420000002000000231
2102000020200002012
1010200200020020101
2001022000002201002
1000120000000210001
2000210001000120002
1002001000001002001
2020000100010000202
1200000010100000021
2121212121212121212