Minefield
KiggD
45
20
15
4 0 0 0 0 0 0 0 0 0 0 1 1 0 0 0 0 0 0 0
0 0 0 0 0 0 0 0 0 0 1 0 1 0 0 0 3 0 0 0
0 0 0 0 1 0 1 0 0 1 0 0 1 0 1 0 0 0 0 0
0 0 1 1 0 1 0 0 1 0 0 0 1 0 1 0 0 0 0 0
0 0 1 1 0 0 0 1 0 0 0 0 0 0 1 0 0 0 0 0
0 0 0 1 0 0 1 0 1 0 1 1 0 1 0 0 0 0 0 0
0 1 0 0 1 0 0 0 0 1 1 0 1 0 1 0 0 0 0 0
1 0 0 0 0 0 1 0 0 1 1 0 0 0 0 1 0 0 0 0
0 0 1 0 0 1 0 0 1 0 1 0 1 0 1 0 1 0 0 0
0 0 0 0 1 0 1 0 0 0 0 0 1 0 0 1 0 1 0 0
0 0 0 1 0 0 0 1 1 1 1 1 0 0 1 0 0 0 0 0
0 0 0 0 0 0 1 0 0 0 0 0 0 0 1 0 1 0 0 1
0 0 0 0 1 0 0 0 0 0 0 0 0 0 0 0 0 1 0 0
0 0 0 0 0 0 0 0 0 0 0 0 0 0 0 0 0 0 1 0
0 0 0 0 0 0 0 0 0 0 0 0 0 0 0 0 0 0 0 0