Tidal Wave
Jamesandpie
56
19
19
0002020020001000000
0210202010120000000
2001020210001000000
0200102010202000000
1012010210001000000
2000001010120000000
0200100110001000000
0012001010202000000
2002210210001000000
3210202010120000004
1011201010001000000
0120020110202000000
0000010110001000000
0201022010120000000
0122010210001000000
2002102010202000000
1020020210001000000
0010202010120000000
0102020020002000000