quadradiants
cdntennispro
167
20
20
10000210000012000012
02212020012020010202
02021022120021201002
00000100222020220100
02122220102100100222
01200001200001222001
20222010222010020212
00010020010002010020
02201202001021201000
22002120202102000122
00100022123220102010
01220201202001220000
10000012202212202212
02212202010020010201
02001020001020201002
20222102102100022102
20100020020200100202
21020201220021022001
12202012002210020014
02012000010020210000