Why me?
lovedky
377
20
20
20202220200000001030
02000102200111102022
00202020012000012002
02202222121011002022
00200010220020121110
01211120221000010020
02000002022122210202
00100011220101000020
01011020100200211002
01000120012011202212
01212020210202000002
02010010001002112222
00001001201202000102
12222221020111010100
00100102102002000202
41010102010112021200
00010100201202010202
22210211200101102022
02000000202102020221
20201000100000002002