Forgive me
Raszlo
515
20
20
11000000201000000000
00021111000012111100
01100000111100102010
00001110002000100210
01010001111110120200
01222100000100000210
01000014110012111100
00102011002010000010
10011010120100111020
00100000102012001010
12221010100100120010
00001001001110202010
02010010200000201010
01100010122122101020
00010010000200021000
01222220111011130101
01000200201000202221
00102001200111200101
02011110202100201200
10000000100000100000