Equality
Jamesandpie
8
12
10
000101130000
001000200100
000221211010
300100200020
221010110020
220004020130
000010101210
000101022001
000020201010
000131010300