The Long Way Home
timhalb
150
19
19
0020202201000111000
0020020001010000201
0112022201010101020
0100220021220001222
0102120201001212020
0100010201001122020
0102201001310220200
0120200120010000101
0100200202122010200
0111111114102201111
0000000201221020201
0220202100202002200
2012021021201010220
0020010200021111100
0100102021200200101
0201221001202221000
0010020201220202100
0120222001022020021
0000020201201010200