Look forward
Raszlo
120
17
15
42022000202002000
20220202220020222
01002000202220100
02020202201002200
01202222202210220
02020220000202020
00202022102221020
22200200200200002
22002020202222120
22020220222202002
00221220100020102
22020012222022020
20220000202020202
23022022010002020
20201002222020202