Whiteboy
Reach
315
20
20
10002020202000020102
02000200002001120010
20220122210010020212
22202001020120010000
00020201001020222100
22222222010000102020
01020002010221020210
00202020200100001010
02020222012212120010
00202010224200001222
02001000202200010000
22202320202012120201
00010101210202020110
02010220100022010020
21222102202020220100
00000020200200021000
22202020112122220222
00111100202001001000
00020011200022020222
02020000202002200000