Round the Bend
KiggD
16
11
11
00000010100
00000300000
01111112100
01000020102
01002020010
10210011000
10000210000
01001000000
10010000000
14100000000
01000000000