Link to the past
Anorhc
58
14
14
10220202000301
12002020111120
10120210200020
00002010202112
10111111110000
00000000202000
11111111101121
11000001000100
01101001222100
02010210000222
02002010101000
02010011000110
21101220022100
41020010000200