mislead
lovedky
221
20
20
24020002000000102222
20210200111200200202
12001112000101201200
00210001020100200202
12000022210021100100
00210100001010200102
12000220201000212222
00212221100210200002
12001000000100102022
00212122211220011112
12001000002202000000
00212122222000122120
02002200010221021200
00010010100001000010
02100222221112221222
20001020202000010000
02102102020101010202
20100010011000010121
20022220200021120202
20000022022203000021