Defence
KiggD
13
15
11
000000000000000
000000001111000
000000100041000
000001000001000
000010001001000
000100100101000
000010010001000
000001000001000
000300001000000
000000000010000
000000000000000