Octopussy
KiggD
30
19
19
1000000000000000001
0010000000000000100
0101000000000000010
0000000000000000000
0000010000100001000
0000001001010010000
0000101100200110000
0222020122022100000
0000200200000200000
2022222201210200000
0000000102420000000
2022222201020200000
0202020200120200000
2022021122102010000
0000001000221010000
0200200221202001000
1100022202102011010
0022120110200000100
3000001111111000001