Shoelace
KiggD
11
9
8
0 0 0 0 0 0 0 0 0
0 4 0 0 0 0 0 0 0
0 0 0 0 1 0 0 0 0
0 0 0 0 0 0 0 1 0
0 0 0 1 1 0 1 0 0
0 0 0 0 1 0 0 0 0
0 0 0 0 0 0 1 3 0
0 0 0 0 0 0 0 0 0
