The Ruins
amelioratio
320
20
20
02000220200020020020
20200001001000200200
01001202020202220122
00101002110112022020
20200202000201020100
00212211110000100200
20200000021222002021
00122120200010012200
20010002020201100202
21222002202201022002
20000112020202002020
20200000100200200210
00212122222110022020
00100010002001223102
01001001020214232200
22210100121012113020
00002010000020020212
20220001111020120000
00010200020121020202
22020201000000022122