Tournament
Raszlo
174
19
16
0001020211111111111
0101020200101111111
0100020200202001111
0111111011202000111
0101020200202110001
0101020200101001101
0000020211110220201
0111111113000200211
0000020211110220201
0101020200101001101
0101020200202110001
0111111011202000111
4100020200202001111
0101020200101111111
0101020211111111111
0001111111111111111