basix
JaggerG
69
14
14
42021200020202
20201020022020
02021202020002
20201020212020
02021202010202
20201020212020
02021202010202
20201020212020
02021202010202
20201020212020
02021002010202
20202020212020
02002200010202
20002020213020