quadrants
cdntennispro
171
19
20
1020000100000100021
1020122001112002020
1112100200200120200
4001000200120121112
2102221110102200010
0102000202100200100
0102000120221112220
0221112102000200002
0200200102020102221
0200100111112100000
1112102020200102200
0200102020100021112
0100221112122100000
2122000200100022100
0100000120221102120
0221112102200202120
0000200100202200201
1101102221112011200
2010200000000000202
2010200111011101130