getting closer.........
lovedky
324
20
19
22000020000202220222
00001121000100200200
21010000100100210214
01222102221200200200
01000010000101010121
00102010021122202020
02011020210200012202
00100010100020002020
12222022221011112200
00001210000210002022
02012121020100110100
01121212110102020100
00000100000122110010
00212221210001001010
00100000102010022222
01002020000100102020
01001110220202010202
22210001121220222020
00000000000202010302