Have fun
Raszlo
222
19
19
0100010001002020110
0200020202000000020
0211220102112221123
0200000102000101020
0100202111101001011
0111020001000010200
0201121122211011020
0020020001000202210
1101010101010101010
0200020202000100020
0211222002112221120
0200020202000100020
0110202111410101001
0002100001000202100
0221210022211200210
0000002100000202100
2120200120202100001
1210201212121212200
2120012121212120212