The Great Attractor
Reach
189
20
20
00002020200002020220
00222022020222020020
02000210202020220220
02202020020222201200
02020220202020000010
02222020200220221222
02010021022002020000
02022020220220220202
00200120202202000212
02022022202002210200
02202020220200020220
22022020202022022002
00220220220220120002
22202002002022002022
00010220222020222102
20220200001202002023
02022222220220201200
20220202422021002022
00202002202000212002
00202000202020002022