banditcom
reach
290
20
20
00100010000000000012
10200222100021122201
00001000321120001000
22212102010000022201
01000010212221122000
01010010100102010222
02101021001000001010
00001010012112221010
01101000102000102000
10201011242010100001
00001020102000202212
22210000011211200123
01000122200010202202
01221201002010012220
01220002000021020102
00110102111210000000
02020002002021122211
00021121020010001000
11020001202010201020
21010001000020002000