Minefield
KiggD
45
20
15
40000000000110000000
00000000001010003000
00001010010010100000
00110100100010100000
00110001000000100000
00010010101101000000
01001000011010100000
10000010011000010000
00100100101010101000
00001010000010010100
00010001111100100000
00000010000000101001
00001000000000000100
00000000000000000010
00000000000000000000