Lolicon
reach
659
20
20
22200000200000000020
00001010101021111100
01112000101010000000
00002110200010111112
01014001111220020200
01222100000120002010
01000010120021111100
00102010010010000010
10011012010100222210
00100010222010100010
12221012000100120210
00001010221210100010
02010010000000022210
01100001111121200010
00010102000020120020
01222101100201301010
01000002012002022010
00102012002112001020
02011102021002012010
20000001000001002000