Spaceship
Raszlo
219
20
20
03011111002001111030
00010000010100001000
01010201222220201010
01102010020201020110
01020201102010202010
01222221020112222210
11020201220010202011
10010100133100101001
00102010011001020100
01020201011010202010
00202020000002020200
10020200111100202001
11202021124112020211
10020200102100202001
11202021120112020211
01020201202010202010
01202021000210020210
01120201202010202110
02110111020211101120
00000000002000000000