water bottle
lovedky
182
20
19
00000002001000200201
22202120222021020020
00010000242022012200
02210010222000020002
00012201000101012220
02200021101122220020
20212221020102011000
20210001202100210200
00020201020120022011
20212021020100210020
02010201202122010000
10112201020102010200
00010011020100212112
20100001202120202000
02202011000110010020
02010102202201010220
02200200010002022002
20011201222102100202
02000201030102002001