flip flops
lovedky
369
20
19
00020202001020000000
01000200010021111102
02020201212020002010
01000110000010202200
00121001221101101200
00010020220200020100
01222102014221120010
01000010010200020210
02202022201101010012
02011001020200010100
00100002100211222102
20100110010200000102
22221002001010201000
00001000101001210022
02022022222200201000
01202010202010220022
00102201020100201202
02002010202012220020
20021201030122020200