The Rabbit Hole
timhalb
12
8
9
00001110
00001011
01111231
11010001
10202211
10020010
10202010
14020110
11111100